+-+-+-+-+-+-+-+-+-+-+-+-+-+-+
  |   |         |     |     |
+ + + +-+ + + +-+-+ +-+-+ +-+
| | | | | | |   |           |
+ +-+ + +-+ +-+ +-+-+-+ +-+-+
|     |   | | |     | |     |
+ + + +-+ +-+ + +-+-+ + + + +
| | |       |           | | |
+-+ + + +-+ + +-+-+-+-+-+ +-+
|   | | |   |   |     |     |
+-+ + +-+ +-+-+ + + +-+-+ +-+
|   |   |     |   | |       |
+-+-+ +-+ +-+ +-+ +-+-+ +-+-+
|   | |   |   |   |       | |
+-+ +-+-+-+-+ +-+ + + + + + +
|   |     | |     | | | |   |
+-+ + +-+-+ +-+-+-+ + + + + +
|       |       | | | | | | |
+-+ + +-+-+-+ +-+ +-+-+ +-+ +
|   | |     | | |         | |
+ +-+ + +-+-+ + + +-+-+-+-+-+
|   |       |   |   |       |
+-+-+ +-+ + +-+ + +-+-+ + + +
|   | |   |   |       | | | |
+-+ +-+ + +-+-+-+ +-+ +-+-+ +
| |     | |   |   |         |
+ +-+ +-+ + + +-+-+ +-+ +-+ +
|   | | |   | |   |   | |   |
+ +-+ + + +-+-+ +-+ +-+-+-+ +
| |   |           |   |     |
+ +-+ +-+-+-+ + +-+ +-+-+-+ +
|           | |       |      
+-+-+-+-+-+-+-+-+-+-+-+-+-+-+
