+-+-+-+-+-+-+-+-+-+-+-+-+-+-+-+
  |       |     |     |       |
+ +-+-+ +-+ +-+ +-+ +-+ + + + +
| | |   |     | | |     | | | |
+ + + + +-+-+-+ + +-+-+-+ +-+ +
|     |     |   | |         | |
+ +-+ +-+-+ +-+ + +-+ + +-+-+-+
| | |     | |         | | |   |
+ + + +-+ +-+-+-+-+-+ +-+ +-+ +
| |     | |     | | | |       |
+ +-+ +-+-+ + + + + + + +-+ +-+
| |   |   | | | | |       |   |
+ +-+-+-+ + + +-+ +-+ + + + +-+
| |   | | | |   | |   | | |   |
+ + +-+ + +-+ +-+ +-+ +-+-+-+ +
|   |     |     | |       |   |
+-+ +-+ +-+-+ +-+ + +-+-+-+ + +
| |         |   |         | | |
+ +-+ + +-+-+-+ +-+ +-+ +-+-+ +
| |   | |     |   |   | |   | |
+ + +-+-+-+-+ +-+ +-+ + + + +-+
|       |     |     | |   |   |
+ +-+-+ + + +-+ +-+ +-+-+-+-+ +
|   |     |   | |     | |     |
+ +-+-+-+ + +-+ +-+-+-+ + +-+-+
| |   | | | |     |   |       |
+ +-+ + + + + +-+ + +-+-+ +-+-+
| |       | | |   |           |
+ +-+-+-+-+ + +-+ + + + +-+ +-+
| | |           |   | |   | | |
+-+ +-+ +-+-+-+ +-+ +-+ + +-+ +
|     |   |   | | |   | |     |
+-+ +-+ + +-+ + + +-+-+-+-+ + +
| |     |     |         | | | |
+ +-+ +-+-+ + +-+ +-+-+-+ +-+-+
| |       | |   |   |         |
+ +-+ +-+ +-+ +-+-+-+-+-+-+ +-+
|   | |   |   | |   | | |     |
+ +-+ +-+ +-+-+ +-+ + + + +-+-+
|       |         | |   |     |
+-+-+-+ +-+ +-+ +-+ + + +-+ + +
|     |   | |   |   | | |   | |
+-+ +-+-+-+ + + +-+ + + + +-+-+
|         | | | | |   | | | | |
+ + +-+ +-+-+-+ + +-+-+ + + + +
| |   |   |   | |       |     |
+ +-+ + +-+ +-+ + +-+ +-+-+ +-+
|   | |     |     |   | | |   |
+-+-+-+-+ +-+ + +-+ + + + + +-+
|   | |   | | | | | |   |   | |
+-+ + +-+ + + +-+ + +-+ + + + +
| |     |       | | |   | | | |
+ +-+ +-+ + + +-+ + +-+ + + + +
| | | | | | |   | | |     | | |
+ + + + +-+ +-+ + +-+ +-+-+ + +
| |         | | |   |     |   |
+ +-+-+ +-+ + +-+-+ +-+ +-+ +-+
|       | | |         |   |   |
+ + +-+-+ + +-+ +-+ + +-+ + +-+
| |       |       | |   | |    
+-+-+-+-+-+-+-+-+-+-+-+-+-+-+-+
